1111111111111
10010000000C1
1000010000001
1P0011E00F001
1111111111111